111111111111111111111111111111111111111111111111
101001010C00000000000000000000000000000000000011
11C0000000C0000000000000000000000000000000000011
1010000000P0000000000000000000000000000000000011
10C0000000C0000000000000000000000000000000000011
10C0000000C0000000000000000000000000000000000011
10C0000000C0000000000000000000000000000000000011
10C0000000C0000000000000000000000000000000000011
10C0000000C0000000000000000000000000000000000011
10C0000000C0000000000000000000000000000000000011
10C0000000C0000000000000000000000000000000000011
10C0000000C0000000000000000000000000000000000011
10C0000000C0000000000000000000000000000000000011
10C0000000C0000000000000000000000000000000000011
100010110000000000000000000000000000000000000011
10C0000000C0000000000000000000000000000000000011
1EC0000000C0000000000000000000000000000000000011
10C0000000C0000000000000000000000000000000000011
10C0000000C0000000000000000000000000000000000011
10C0000000C0000000000000000000000000000000000011
10C0000000C0000000000000000000000000000000000011
10C0000000C0000000000000000000000000000000000011
10C0000000C0000000000000000000000000000000000011
111111111111111111111111111111111111111111111111
111111111111111111111111111111111111111111111111