1111111111111
1000011100001
100001PE00C01
1000001100001
1111111111111