1111111
1E00001
10C00P1
1111111
