1111111111111
1001000000001
1000011111011
100011E00C001
1111111111111