1111111111111
1001000000001
1000011111011
100011E01C0P1
1111111111111